«Властелин колец»	Толкин
«Гордость и предубеждение»	Остин
«Тёмные начала»	Пулман
«Автостопом по галактике»	Адамс
«Гарри Поттер и Кубок огня»	Роулинг
«Убить пересмешника»	Ли
«Винни Пух»	Милн
«1984»	Оруэлл
«Лев, колдунья и платяной шкаф»	Льюис
«Джейн Эйр»	Бронте
«Уловка-22»	Хеллер
«Грозовой перевал»	Бронте
«Пение птиц»	Фолкс
«Ребекка»	Дюморье
«Над пропастью во ржи»	Сэлинджер
«Ветер в ивах»	Грэм
«Большие надежды»	Диккенс
«Маленькие женщины»	Олкотт
«Мандолина капитана Корелли»	де Берньер
«Война и мир»	Толстой
«Унесённые ветром»	Митчелл
«Гарри Поттер и философский камень»	Роулинг
«Гарри Поттер и Тайная комната»	Роулинг
«Гарри Поттер и узник Азкабана»	Роулинг
«Хоббит, или Туда и обратно»	Толкин
«Тэсс из рода д’Эрбервиллей»	Харди
«Миддлмарч»	Элиот
«Молитва об Оуэне Мини»	Ирвинг
«Гроздья гнева»	Стейнбек
«Алиса в Стране чудес»	Кэрролл
«Дневник Трейси Бикер[en]»	Уилсон
«Сто лет одиночества»	Маркес
«Столпы Земли»	Фоллетт
«Дэвид Копперфильд»	Диккенс
«Чарли и шоколадная фабрика»	Даль
«Остров сокровищ»	Стивенсон
«Город как Элис»	Шют
«Доводы рассудка»	Остин
«Дюна»	Герберт
«Эмма»	Остин
«Аня из Зелёных Мезонинов»	Монтгомери
«Обитатели холмов»	Адамс
«Великий Гэтсби»	Фицджеральд
«Граф Монте-Кристо»	Дюма
«Возвращение в Брайдсхед»	Во
«Скотный двор»	Оруэлл
«Рождественская песнь»	Диккенс
«Вдали от обезумевшей толпы»	Харди
«Спокойной ночи, мистер Том»	Магорян
«Семейная реликвия»	 Пилчер
